0,0,0,2,1,1,2,0,0,0
0,0,0,2,1,1,2,0,0,0
0,0,0,2,5,1,2,0,0,0
2,2,2,2,3,3,2,2,2,2
1,1,1,3,4,4,3,5,1,1
1,1,5,3,4,4,3,1,1,1
2,2,2,2,3,3,2,2,2,2
0,0,0,2,1,5,2,0,0,0
0,0,0,2,1,1,2,0,0,0
0,0,0,2,1,1,2,0,0,0